WWWWWWWWWWWWWWWWWWWWWWWWWWWWWWWWWWWWWWWWWWWWWWWWWWWWWWWWWWWWWWWWWWWWWWWWWWWWWWWWWWW
WPWCCCWCCCWCCCWWWWCCCWWCWWWWWWWWWWWWWWWWWWWWWWWWWWWWWWWWWWWWWWWWWWWWWWWWWWWCCCCWCWW
WCWCWCWCWCWCWCWWWCCWCWCCCWWWCCCCCCCCCCCCWWWWWWWWWWWWWWWWWWWWWWWWWWWWWWWWWWWCWWWWCWW
WCCCWCWCWCWCWCWWWCWWCWCWCCWWCWWWWWWWWWCCCCCCCCWWWWWWWWWWWWWWWWWWWWWWWWWWWWWCWWWWCCW
WWWWWCWCWCWCWCWWWCWCCWCWWCWWCWWWCCCWWWCWWWWWWCCCCCCCCCCCCCCCCCCCCCCCCCCCCCCCCWWWWCW
WWWWWCWCWCWCWCWWWCWCWWCWWCWWCWWWCWCCCWCWWWWWWWWWWWWWWWWWWWWWWWWWWCWWWWWWWWWWCCWWWCW
WCCCCCWCWCWCWCWWCCWCWWCWWCWWCWWWCWWCCCCCWWWWWWWWWWWWWWWWWWWWWWWWWCWWWWWWWWWWWCWWWCW
WCWWWWWCWCWCWCWWCWWCWWCWWCWCCWWWCWWCWCCCWWWWWWWWWWWWWWWWWWWWWWWWWWCWWWWWWWWWWCCCCCW
WCWCCCCCWCWCWCWWCWWCWWCWWCWCWWWWCWWCWWCCWWWWWWWWWWWWWWWWWWWWWWWWWWCWWWWWWWWCCCWWWWW
WCWCWWWWWCWCWCWCCWWCWWCWWCWCWWWWCWWCWWWCCCCCCCCCCCCCCCCCCCCCCCCCCCCCCCCCCCCCWWWWWWW
WCWCWCCCCCWCWCWCWWWCWCCWWCWCCWWWCWWCWWWCWWWWWWWWWWWWWWWWWWWWWWWWWWWWWWWWWWWWWWWWWWW
WCWCWCWWWWCCWCWCWWCCCCWWWCWWCWWWCWWCWWWCWWWWWWWWWWWWWWWWWWWWWWWWWWWWWWWWWWWWWWWWWWW
WCWCWCWWWWCWWCWCWWCWCWWWWCWWCWWWCCCWWWWCWWWWWWWWWWWWCCCCCCCCCCCCCCCCCCCCCCCCCCCCCWW
WCWCWCWWWWCWCCWCWWCWCWWWWCWWCWWWWCWWWWWCWWWCCCCCCCCCCWWWWWWWWWWWWWWWWWWWWWWWWWWWCWW
WCWCWCWWWWCWCCWCWWCWCCCWWCWWCCWWWCCWWWWCWWCCWWWWWWWWWWWWWWWWWWWWWWWWWWWWWWWWWWWWCWW
WCWCWCCCCWCWCWWCWWCCWWCWWCWWWCWWWWCWWWWCWCCWWWCCCCCCCCCCCCCCCCCCCCCCCCCCCCCWWWWWCWW
WCWCWWWWCWCWCWWCCWWCCWCWWCWWWCWWWWCWWWCCCCWWCCCWWWWWWWWWWWWWWWWWWWWWWWWWWWCCCCWWCWW
WCWCCCCWCWCWCWWWCCWWCWCWWCWWWCWWWWCCWWCWCWWWCWWWCCCWWWWWWWWWWWWWWWWWWWWWWWWWWCCCCWW
WCWWWWCWCWCWCCWWWCWWCWCWWCWWWCWWWWWCWWCWCWWWCWWCCWCCCCCCCCCCCCCCCCCCCCCCCCCCCWWWWWW
WCCCCWCWCWCWWCWWWCCWCWCWWCWWWCWWWWWCWWCWCCWWCWWCWWWWWWWWWWWWWWWWWWWWWWWWWWWWCWWWWWW
WWWWCCCCCCCCCCCCCCCCCCCWWCWWWCWWWWWCCWCWWCWWCWWCWWWWWWWCCCCCCCCCCCCWWWWWWWWWCCWWWWW
WCCCCWCWCWCWCWWWWWCWCCCCCCCCCCCCCCCCCCCCCCCCCCCCCCCCCCCCCCCCCCCCCCCCCCCCCCCCCCCCWWW
WCWWWWCWCWCWCWWWWCCWCWCWWCWWWCWWWWCWWCCWWCWWCCWWCWWWCCWWWCCCCCCCCCWWWWWWCCWWWCCCCWW
WCCCCWCWCWCWCWWWWCWWCWCWWCWWWCWWWWCWWCCWWCWWWCWWCWWWWCWWWCCWWWWWWCCCWWWWWCCWWWWWCWW
WWWWCWCWCWCWCWWWCCWWCWCWWCWWWCWWWWCWWCCWWCCWWCWWCCWWWCCWWWCWWWWWWWWCCWWWWWCCCWWWCWW
WWWWCWCWCWCWCWWWCWWWCWCWWCWWWCWWWWCWWWCWWWCCWCCWWCCCWWCCWWCWWWWWWWWWCCCWWWWWCCCCCWW
WCCCCWCWCWCWCWWWCWWCCWCWWCWWWCCWWCWWWWCCWWWCCWCCWWWCCWWCCWCCWWWCCCWWWWCCCWWWWWWWWWW
WCWWWCCWCWCWCWWWCWWCWWCWWCWWWWCWWCWWWWCCWWWWCCWCCWWWCWWWCWWCWWWCWCCCWWWWCCWWWWWWWWW
WCWCCCWCCWCWCWWWCWWCWWCWWCCWWWCCWCWWWWCCWWWWWCCWCCWWCWWWCCWCWWWCWWWCCCWWWCCCWWWWWWW
WCWCWWCCWCCWCWWWCWCCWCCWWWCWWWWCCCWWWWCCWWWWWWCWWCWWCCWWWCWCCWWCWWWWWCCWWWWCCCWWWWW
WCWCWCCWCCWWCWWWCWCWWCWWWWCWWWWWCCCCCWCCWWWWWWCWWCWWWCWWWCWWCCCCWWWWWWCCWWWWWCWWWWW
WCWCWCWCCWWWCWWWCWCWWCWWWWCWWWWWWWWWCWCCWWWWWWCWWCWWWCWWWCWWWCCWWWCCCWWWCCWWWCCWWWW
WCWCWCWCWWCCCWWWCWCWWCWWWWCWWWWWWWCCCWWCWWWWWWCWWCWWWCWWWCWWWCCWWWCWCCWWWCCCWWCWWWW
WCWCWCWCWWCWWWWCCWCWWCWWWWCWWWWWWWCWWWCCWWWWWCCWWCWWCCWWWCWWWCCCWWCWWCWWWWWCCCCWWWW
WCWCWCWCWCCWWWCCWWCWWCWWWWCWWWWWCCCWWWCCWWWWWCWWWCWWCWWWWCWWWCWCWWCCWCWWWWWCWWWWWWW
WCWCCCCCCCCCCCCCCCCCCCCCCCCWWWWCCWWCCCCCCCCCCCCCCCCCCCCCCCCCCCCCWWWCWCWWWWCCCCCCCCW
WCWCWCWCWCWWWWCWCCWCCCWWWCCCCCCCCCCCCCWCWWWWWCWWWCWWCWWWCCWWCCWCCWWCWCCWWWCCCCCCCCW
WCWCWCWCWCWWWWCWCWWCWWWWWWCWWWCWWWWWCWWCWWWWWCWWWCWWCWWCCWWWWCWWCWWCWWCCWWCCCCCCCCW
WCWCWCWCWCWWWWCWCWWCWWWWWWCCWCCWWWWWCWCCWWWWWCWWWCWWCWWCWWWWWCWWCWWCWWWCCWCCCCCCCCW
WCWCWCWCWCWWWWCWCWWCWWWWWWWCCCWWWWWWCCCWWWWWWCWWWCWWCWWCWWWWCCWWCCWCWWWWCCCCCCCCCCW
WCWCWCWCWCCCCCCWCWWCWWWWWWWWWWWWWWWWWWCCCCCCCCWWWCCCCWWCCCCCCWWWWCCCWWWWWCCCCCCCCCW
WCCCWCCCWWWCCWWWCCCCWWWWWWWWWWWWWWWWWWWWWWWWWWWWWWWWWWWWWWWWWWWWWWWWWWWWWWCCCCCCCEW
WWWWWWWWWWWWWWWWWWWWWWWWWWWWWWWWWWWWWWWWWWWWWWWWWWWWWWWWWWWWWWWWWWWWWWWWWWWWWWWWWWW