WWWWWWWWW
WFPFFFFFW
WWWWWWWWW
WFFCCCFEW
WWWWWWWWW